-_---------_----_----------------------_---------_---_--------------------------------------------------------_------_-_-----_--------__------------------_-------------_----------------------_---_-__-
------_----_----------_------__------_-------------_-_----_----_------_------_-----------_--_-----------------------------------_----_--------_----_-----------_--------------_--------------------_----
_------------------_--_-------------------------------------_--------------------_-------------------_----------------------_-------_----__-------_-------_----------_--------_------_--------_---------
--_---------------_------------------------_----_-_--------_-----------_-_--_---_-------------__---------_----------------_------------_-----------------_---_------_------------_-------------------_--
_---------_---------_-------------------_---------------------------------_----_------------_----_----------_-_---_-----~------------------------------_-----_--_------__---------------------------_---
-----------_---------------------------------------__---------------_-------_------------------------------------_--_----~~--_---_--_---------__------_-------------_------------_------_------~-~------
----------------------------------------------------_---_------_--_------_---------------------------_-_------_-------~~--~------_-----------_-----------_--_--_-----___-----_-----------_-_-----~~-----
--------------------------------------------------_--------_---__-------------~~~-----------------_---_--------------------~~-------------------------__----------------_----_----------_---_--~-~------
--_--------------------_------------------------_-----------------------_------~--~--__----------------_------_------------~-~-~-_--~~------------__-----------------_--------_---------_----~-~~~--_---
_---------__----------------------------------------_-------------_---_------_-----~---_-_--_-------_----------------------~-~~----~~~~--------------------------------------_------__------~-~---_-----
---------_--_---------------------------_-_---------------__-------------------------------------------_------------------_--------~~~~-------------------------------------_---_------_-------~---_----
----_------__------------------------------_--------_----MM_-------_-----------_---------_------------~-----_------------__~~--~----~~-------------------------_-------_____-----_------__~~~~---~------
------------_-------------_-------__---_--_---------_----__M---------_---_----------------------------~-~------------------_~~~---------------------_------------_-----_---_--~----------~~~~~~--------_
--------_------------------------~~---------------_----_-_M_-----------_----------_-------_--------_~~--~-----------------_------~-------------------------_------------------~---------~~~~~~----------
----------------------------------------------------_------_-------------_-------------------_--------~~~--------------_--_--~~~-~-------------------_-----------_---_-------~~---------~~~~~~_----_----
---_---_------------------------~-~--_-------------------_------------------_----------__---------------~------------_----_--~-----------------_----------_--------------_--~~-~--------~~~~~~_---------
-----_----------------------------~-_--_---------------_---------------------_-_-----------_---_-----~--~------------------~~~--~--------------_---------------------_-_---~~---_-_------~~~~-----------
------------------------------------------------------------------------------_---------------~~------~-----------------_-_~-~~~--__--------------------------~~-----_-----------_--------~~------------
-------_----------------------------_----------------------_-------------------_---------_----~-----------------_--~~-----_---~~~------------_--_------------~~~~----_------------------------_-_-------
_-_--_---~-~-~------------------------------------------------_--------------_--------~~-------~~-~----------------~---_--_---~-~_----_---------__---------_-~~~~-----------_--_-_---------------_------
_-_----_-~~~~--~~-----------------------------------------_---_----------------------~~~~~--------------------------~-_------~------------_-------------------~~-------------_------------------------__
------------~~--~------------------------------------------------_---------------~~--~~~~~~~~---~-~------------------~-_--------------_--------------_-------------------------------------_-_---__--_--
---_------~~-~~---~----------------~------------------MM-------_----------------~~----~~~_-----~~-----------------~-~--------------------_----_-_----------_-----------------------------_--------------
----_-------~-~-~-~----------------~-----------------MMM_----------------------~--~--_-----~-------~-~_----------~--~~--------------------------------------------------------------------------_-------
------------~-----~---------------~~-----------------MMM_----------------------~~-------------~~~--~~-~----------~----~----_---------~-~_-----------------------------------------------------_---------
_---_----------~------------------~--~---------------__M_--------------------~~~---~--_----~----~~~~-~--~-------------~-------------~-~-~--~--_----------------------------------------------_----------
---------_----~-~-------------------------------------___-------------------------~-----_---~-~~~~-~~~--~--------~--~~--------------~~~~----~-----_----------------------------------------------_-----_
-_--------------~---------------------------------------------------------------~----------~~~-~--~~~-~~----------~~~-~----_----------~-~~------_-_----_------------------------------------------------
---_---------------------------------------------------------------------------~-----_----~~--~---~---~~~---------~~~~_-----_----------~~~~~------_-----------------------------------------_--_-_------
------_-------------------------------------------------------------~---------------_------~~-~------~-~---------~~~~~~---------------------~----------------------------------------------_-------_----
-------------------------------------------------------------------~-~--------M_-----------~------~--~~~---------~~~~~~------------~~-~--~~~~~~_---------_----------------------------------------------
----------__----_--__----------------------------------------------~~--------M_M_---------~~--~--~-~----~~~-------~~~~~~---_------~~~~---~~-~~-~----------------~------------------~--------------------
-------------------------------------------------------------------~--~-----MM_MM--------~----~---~~-----~~--_------~~~~~__-------~~~~~--~~-~--~-----------------~--------------------------------------
------------------__------------------------------------------------------_-__MMM--------~--~~~~~----~~~-~-_--_------~~~~~_--------~~~~~~-~--~~-~-------_-----~-~--~----------------~-------------------
--_-----------------_------------------------_-------------------------------_M__------------~-~-~~------~~---_-_-_-~~~~~~---_------~~~~~---~-~--~---------_-~~-~-~-----------------~-------------------
------------_--_--------------------------------------------------------_--_--__-----------~--~----~~-~~~-~------------~~-----------~~~~~~----~~~------------~~-~~--~--_----------_---------------------
--_---------------------------------------_---------_-------------------------------------~--~~-~~~~~-~~-~------_--~~~~-------------~~~~-~~--~----~--------__~---~-~~-----------------------------------
---_-------------------------------------------------------------------------------------~--~--~~~-~~---~~~--------~~~---------------~--~~~------~~----------~~-~-~----_----------_-_---_---------------
------------------------------------------------------------------------------------------~-----~~~~-~~--~-~-----__~~-~~~_-------------~-~----~~~~------------~-~-_-----------------_-------------------
-----------------------------------------------------------------------------_----------~-~~~-~~-~----~~------------~-~~--_-----------~--~--------_------------------~---------------------------------_
-----------------------------------------_---------_-----------------------------_-------~--~-~--------~~~--------------~----------~--~-~~---------------------------~-~--------_-_--_------------------
---------------------------------------------_-------MM--------------------_-------------~-~--~~-----_-_-~---------~~-~-------------~~-~~--~-----------------------_--~~-----~-----------_--------------
----------------------------------------------------_M_M-------------------_-----_----------~~---~-~------------------~~-----------~-~---~~--------_-----------------~~-~-----~-_-----------------------
-_-_-----------_----------------------------_---_---___M_M_----------------------_--------------~~-~--_-------_M_~--~-~~~--~---------~-~~-~~--------_---------------_-~------~-_M---------_-------------
--_-----------_----------------------------------_---MM__M__-----------------__-----------------~--~---------_____-~----~~~--------------~---------_--------------------------_M___-_-------------------
_-------------------------------------------------_---_MM___-------------------------------------------------M_MM_M-----~~--_--------~_______________________-----------_--__-___M-~--------------------
--_--------------------------------------------__--_----_M_----------------~_-_----------------------_-------M_M_MM_----~---------______________________________________------__M---_______________-----
-_--------~__--_-------------------------_---------_----------------------~---_---------------------------_---_____MM-~---------_____________________________________________----_____________________--
---------~~~--------------~-~-~----------_------------_--------------------------------------------------_-----M_____---------________________________________________________________________________--
---_----_~~~--_-__--------~--~~----------------------_---------------------_------------------------_--_--------____M-------____________-~--~--------------___________________________________________--
---------~~~--------------~---~------------__--_----------------------------------------------------_--__--_----~_MM__----___________---~--~--------------------~~~~-__________________--------_______--
----------~-_---------------~~-~--------------------_-------------M_--------------------------------------------~~M_M__---_________-~-~~~--------------_-----~--~~-~~~-~~-~~________--------------------
----------------------------~-~~---------------_-----__----------_MM_M_------_-----------------------_-----------~____M-__________------------------_-----------~~-----------------_--------------------
------------------------------~-----------_------_---__----------_______-----~~--_---------------------------------_M_M_________--------------------_-_------~-~-~----~--~~~~~-~-----------------------_
-_------------------_--------_-------------------_--_-------------M_M___----~~~~_---------------~~------------------M_________-------------------------_-----------~~-~-~--~-----_-_--------------------
-_--------------_----_----_-_-------------------------------------_M_MM-----~~~~---------------~~~~------------------________---------------------------__-----~-~~-~~~~-~~~-~--_------_----------------
---_----------------------------------------------_----------------__M------~~~~---------------~~~~-__--------------_______------_------------------------------~---~~-~-~-~-----_-----_----------------
------_---------_--------__--------------------------_---~~-----------------_~~~---------------~~~~----------------_______------------------------------_-------~--~~-~--~~-------_---------------------
----_----_---------------_--_----_----------------------~---------------------~~~---------------~~------_------~--_______-------------_---------------------------~~~~-~-~~-------_---_-----------------
-_---_-----------------_-_------------------__-----------~~------------------_-~~~-----------------------_-----~-~______--~-----------------------------_--------_~~~~-~-~------_--_--------------------
-----------------------------------~------MMM__---------------------------------~~~~-------------------~-------~~______--~~~-------------_----------_--_-----------~~~~---~~-~------~-_-----------------
--------------------------_-----_--------_MMM_M--------_-------------------------~~~~-----_-------------_--------_____---~~-----------------------------_-------------~~~~---~-----~~-------------------
----_--_-----------------_------_---~~---___M_-__---_-----------------------------~~~~---------------~-~~------______--~~---~----------------------------------------~-~---~------~---_-----------------
--------~~--_--------------_------_-~~----___--------------------------------------~~~-------------~-~-~~-----_______--~-~-~---------------_----------------------_----~--~--~--------------------------
---------~~-_---------------_---------~~---------_-__--_M_-------------------------~~~-------------~-~--------______----~~--~---------------------M------------_M_MMM_____MM_M_--------_----------------
---------------------_-------------------------_------_M_MMMMM---~------------------~~~-----------~-----------______-----~----------------------___M----------MM_M___M__MMM_MMM_MM-----_----------------
---_---~------------------------_---------------------M__M_____----------------------~~~--------~---~---------____--------------------------------_M---------_M__M____MMM____MM_MM---_---~--------------
------------------_------------------------------------_MM_MMMM----------------------~~~~----_--~-~~-~~-------____---------------------------_--____------_-__MMM_MM_MM_M_MMM__M__---__-~~--------------
-------_---------------~~------------------------------_MMMM_M_-----------------------~~~-------~---~-~~-----_____----------------------------___-_M-------______MMM_MMMMM_M_MM__M-----~~-~-------------
--------~-------------~~~~------------------------------MM__M_--------~~~-------------~~~--------~~----------____----------------------------------__-----MMM_MMMMMM_M__MMMMMMM___------~~--------------
------_---------------~~~~----------------_-------_-_----MMM--------~~~~~~-----_------~~~--------~~~---------____----------------------------------_M-----_MM__MMM___M__M__M_M_M_M----------------------
---------~_--------_-~~~~~------------------------_----------------~~~~~~~--------_--~~~~---------~-~~-~~----____-----------------------------------------M_MMMM_MM_MMMM__M_MM_M_M--------~~~-----------
-------~-------------~~~~~~-----------------_------_---------------~~~~~~~-----------~~~~------------~--~~---_____----------------------------------------MM_MM______MMM_MMMMMMMMM-------~~~~~----------
------~~--------------~~~~~-----------------_-----------------------~~~~~~-----------_~~-------------~~-~-~--_____----------------------------------------MMM_MMMM_MMMMM__M_M_M__M-------~~~~~----~~~~--
----------------------~~~~~-------------------------------------------~~~~-------------_---------------------______---------------------------_-----------MM__M___MMM__MM_MMM_MM__-------~~~~----~~~~~~-
--------~~--_-------__-~~~~~-------------------------------------~-----~~~~--------_-------------------~-----______----__-------------------_-------------MMM_M_MMM__M_MM_M_M------------~~~~----~~~~~~-
-_------~-~-------------~~~~~-----------------------------------~-~----~~~~--------__------------------~--~_--______--------------------------------------MMMMMMM__MMM__MMMMM----__-------~~------~~~~--
--_-----~~~--_---------_~~~~~~-------------~~-~--~~~~---------~---~-----~~------------------------------------_______----_-----------_--------------------MMMMMMM_M_MM___MM_M----------------------~~---
----------~_-------------~~~~~------------------~~~~~~------~~--~~--------------------_-----------------~--~---_______--_---------------------------------MMMMMM_MMMMMM__MM__---------------------------
-_------~~----------------~~~---------------~~~~~~~~~~-----~~---~~---------------------------------------~~---~-________----------------------------------__M__MMMMMM_MM_MMM_---------------------------
--------~----------------------------------~-~-~~~~~~~-----~~----~--------------------------------------~-----~-___________------_----_-------------------M__M__MMM_MMM_MMMMM---------------------------
--_-----------------------------------------~-----~~~~-------~-~--------------------------------------~-~---~~--~___________----_-------------------------MM__M_MM_MMMMMM____---------------------------
-_-------------------------------------------------~~------------~~--------------~~--------------------~-~---------___________----------------------------MMMMMMMM_M___MMM_----------------------------_
---------------------------_----__---------------------------~~~----------------~~~-------------------~-~~~~--~---~--__________-------_--------------------MMMMM__M___M_M_------------------------------
--_-----------------------------------------------_-_--------~-~-_---_---------~~~~-_-----------------~~~~~~-~-~-~~-_---_________----~-----------------------MM__M_M__MMM---_--_------------------------
-------------------------------------------------_-------------~-_--------------~~~~--~----------_-----~------~-----_-----________~--~---------------------------------_----------------------_---------
--_----------------_--------------------------------------------_----------------~-~-~-~---------_----~-----~----~---------_________---~------------------~----------~~-_--------------_------_---------
----------------------------------------------__-----------------------------------~----~------------_-~~~--~~--~~~~---------_______~~-~~---------------~------------~~-_-----_-------------------------
--_-_-------------~-~--------------------------------_-------------------------------~~-------------_---~-------~---~---------_______-~----------------~-~-~~---------~~---__---_-~-------_-------------
-----_------------~~~-~__---------------------~~---------_-------_--------------------~--------------_--~-----~~----~-----------_______----------------~---~~---------~~------_-----~_------------------
------_------------~--~-_--------------------~~~~----__-_----------------------------~-------------------~---~~-~--~~-~---------________----------------~---~---------~~---_--_-------------_-----------
--__----------------------------------------~~~~~---~-------------------------------~--------------------~---~--~-~~-----------~-_______-----------------~~-~---------~~~-----_---------------------_--_
_--_---------~~----------_------------------~~~~~---~------------------------------~-~------------------~--~-~~-~-~---~---------~~-_________--------------~~-----------~~---------~~-----_--------------
------_-----~--~---_--_---_------------------~~~~---~----------------------------------__--------------------~-~-~~-----------~~~---________-------M------~~~----------~~~_-----------------------------
-------------~-~----___------_----------------~~----~--_--------------------------M_-~__M_---------------~~--------~------------~-----______-_-------------~-~----------~~-_---------~--_---------------
_-----------~~-~----_-------_------_----------------~-----_----------------------__M___M_M-----------------~~-~---~-~~----------~~----______-----------------~----------~~~~--_-_---~~------------------
------_-_---~-------------------_-------------------~--~--_----------------------M____M_MM----------_------~~-~~-~----------------------_____-------------~~-~-----------~~~~---------------------------
---------_--~-~~-------------------_-----------------~---~-----------------------_M_MM_M__~-~------__------------------------------------------------------~--------------~~~~~~~~~--~---~~~~~----------
--_--_----_--~--_-_--------------_------------------~~~~~~--_---------------------_M_____-------------_---------~--~---------------------------------------------_----------~~~~~~~~~~~~~~~~~~----------
-------------_------------------_-----------------------~---------------------------_-M_----~~----------_--_-----~-----------------------------------------------------_----------~~~~~~~~~--_----------
FIN DE GRILLE
NORD
VIOLENT
0.9
34
40
71
137
