--------------_-------__----------------_--_------
------_-_-------_----_-_-_----------------_-------
-------------------------_------------------------
---__------_---__------_---------------_----------
---------_---_--_--_--------------_----_---------_
---_------~~----_----------------------_----------
---_-----~~~~_-----------_------_----------_------
---------~~~~--------------------_---------_------
----------~~-----_-----------------------_--------
_---------------------_---------------------------
-__-------------------_---------------------------
--------------_----_--------------------_---------
_---_-----------------_---------------------------
-------_---_--------------------_---------_---__--
---------_----_-----_-----------------------------
---__---------------------------_-----------------
------------------------------------------------_-
-----------------_-----------------_--------------
----_-_--_----_-------------------_------------_--
-----------_-------_----------------------------_-
------------_------_---------_--------------------
--_-----------------------------_--_----_---------
---------------------_-------------------------_--
-_----------------_------------------_------------
_----------------------------------_--------------
_--------------------------------_------_--_--_---
--------------_------_-_-------_------------------
------------------------_-------_--_--_--------_--
--_--------MMM-----------------------------------_
----------MMMMM-----------------_-----------------
----------_M____----------_----_------------------
-----------_MMM_M-----_---------------------------
------~-----_M___M-------_------------------------
-----_~-----MMMMMM--------------------------------
-------~~---MM_MM_--_------------_----------------
--------~----M_M_M-------------_------------------
--------~----MM__--------_-_---_------------------
_--------~----_M_-_--_--__M-----------------------
-_-------~--~------------_M------------------_----
--------~----------_-----_M-----------------------
----_----~~---~-----------MM--------------------_-
-------~-~~---------------M_----------------------
---------~----------------MM----------------------
--------~~~------------_--------------_M----------
------_~-~----------_----------------MM_M---------
-_------~-_--------------------------M_MM---------
-------------_-_----------------------_M----------
-------------_-_----------------------------------
-------------_-------_-----_----------------------
_--_--_-------_-----_-----------------------------
FIN DE GRILLE
NORD
NUL
0.1
